C 173,216,255
NO ./ray_casting/textures/n.xpm
SO ./ray_casting/textures/s.xpm 
WE ./ray_casting/textures/w.xpm
F 200,200,255
EA ./ray_casting/textures/e.xpm

        1111111111111111111111111
        1000000000110000000000001111111
        10110000011100000000000010011
11111111111111111111111111111111111
111111111111111111111111111111111111111111
100000000011000001110000000011111
10000000000000000000000000001
10000000000000000000000000001
10000000000000000000000000001
10000000000000000000000000001
10000000000000000000000000001
10000000000000000000000000001
10000000000000000000000000001
10000000000100000000000000001
10000000000N1000000000000001
10000000000000000000000000001
10000000000000000000000000001
10000000000000000000000000001
10000000000000000000000000001
10000000000000000000000000001
10000000000000000000000000001
10000000000000000000000000001
10000000000000000000000000001
10000000000000000000000000001
10000000000000000000000000001
10000000000001000000000000001
10000000000010000000000000001
10000000000000000000000000101
1100000111010101111101110111111
11110111 1110101 101111010101
11111111 1111111 111111111111