C 173,216,255
NO ./ray_casting/textures/n.xpm 
SO ./ray_casting/textures/s.xpm 
WE ./ray_casting/textures/w.xpm 
EA ./ray_casting/textures/e.xpm

F 1,0,255


        1111111111111111111111111
        1000000000110000000000001111111
        10110000011100000000000010011
        1001000000000000000000001111111
11111111101100000111000000000000111
100000000011000001110000000011111
11110111111111011100000010001
11110111111111011101010010001               
11000000110101011100000010001               
10000000000000001100000010001           
10000000000000001101010010001
11000001110101010111011110E0111
11110111 1110101111111010001
11111111 1111111 111111111111